d →  d
D →  D
a →  a global
A →  A global
au →  a rust
Au →  A rust

t  → systemctl
tu → systemctl --user
systemctl ← dr → daemon-reload
systemctl ← d → disable
systemctl ← e → enable
systemctl ← r → restart
systemctl ← s → start
systemctl ← c → status
systemctl ← o → stop

c  → cargo
ca → cargo.nu
cargo ← cc → clippy --fix --workspace --allow-dirty --allow-staged

at → alien_temple
e  → helix
f  → z
gz → glaza
gx → glaza -g

cp   → rsync -r
mM   → chmod +x
hime → history merge
l    → jobs
mkd  → mkdir -p
rm   → gomi
rmf  → rm -fr
sude → sudo -E
x    → http_proxy=http://127.0.0.1:8118 https_proxy=http://127.0.0.1:8118
chex → path change-extension
fw → and flourish¬or wither

qrtool → qrtool.rs
u      → pueue.nu
tz     → tz -q Europe/Moscow UTC

ls → eza
la → eza -a
le → eza -l
lw → eza -al

nas → na --stdin
nac → na -c '█'
nasc → na --stdin -c '█'

gh ← si → search issues
gh ← sc → search code

magick ← loss → -define webp:lossless=true

ei → sudo -E helix /usr/share/applications/█.desktop
eui → helix ~/.local/share/applications/█.desktop
E  → sudo -E helix
de → cd ~/fes/dot && helix
fC → sudo -E helix /etc/fancontrol
fc → cat ~/fes/uviw/afen/sudo | sudo -S systemctl restart fancontrol
